###########
#      #S #
#   #    ##
# #########
#        X#
###########
